x=28
y=31
XXXXXXXXXXXXXXXXXXXXXXXXXXXX
X............XX............X
X.XXXX.XXXXX.XX.XXXXX.XXXX.X
XoX  X.X   X.XX.X   X.X  XoX
X.XXXX.XXXXX.XX.XXXXX.XXXX.X
X..........................X
X.XXXX.XX.XXXXXXXX.XX.XXXX.X
X.XXXX.XX.XXXXXXXX.XX.XXXX.X
X......XX....XX....XX......X
XXXXXX.XXXXX XX XXXXX.XXXXXX
     X.XXXXX XX XXXXX.X     
     X.XX          XX.X     
     X.XX XXX--XXX XX.X     
XXXXXX.XX XGGGGGGX XX.XXXXXX
=     .   XGGGGGGX   .     =
XXXXXX.XX XGGGGGGX XX.XXXXXX
     X.XX XXXXXXXX XX.X     
     X.XX    B     XX.X     
     X.XX XXXXXXXX XX.X     
XXXXXX.XX XXXXXXXX XX.XXXXXX
X............XX............X
X.XXXX.XXXXX.XX.XXXX.XXXXX.X
X.XXXX.XXXXX.XX.XXXX.XXXXX.X
Xo..XX................XX..oX
XXX.XX.XX.XXXXXXXX.XX.XX.XXX
XXX.XX.XX.XXXXXXXX.XX.XX.XXX
X......XX....XX....XX......X
X.XXXXXXXXXX.XX.XXXXXXXXXX.X
X.XXXXXXXXXX.XX.XXXXXXXXXX.X
X..........................X
XXXXXXXXXXXXXXXXXXXXXXXXXXXX
